10
-.-.-.-.-.-.-.-.-.-
-.-.-.-.-.-.-.-.-.-
-.-.-.-.-.-.H_P.-.-.-
-.-.-.-.W.G.-.-.-.-
-.-.-.-.P_G.-.-.P.-.-
-.-.-.-.-.-.-.-.-.-
-.-.-.-.-.-.-.-.-.-
-.-.-.-.-.-.-.-.-.-
W.-.-.-.-.-.-.-.-.-
-.-.-.-.-.-.-.-.-.-
