10
-.-.-.-.W.-.-.P.-.-
-.H_P.-.-.-.-.-.-.P_G.-
-.-.-.H_P.-.-.-.-.-.-
-.-.-.-.-.-.-.-.-.-
-.-.-.-.-.-.-.W.-.P
-.-.-.-.-.G.-.-.-.-
-.-.-.-.-.-.-.-.G.-
-.-.-.P.P.-.-.-.-.-
-.-.-.-.-.-.P.-.W.-
-.-.-.-.-.-.-.-.G.-
